#####     #####
#             #
#             #
#       @     #
#             #
#
#
#
#
#
#             # 
#             #
#             #
#             #
#####     #####