#################
#      @        #
#               #
#               #
#               #
#               #
#    H H H      #
#               #
#    P P P      #
#               #
#    A A A      #
#               #
#    B B B      #
#               #
#               #
#               #
######     ######