#######################
#     #               #
#                #### #
#                #  # #
#                #  # #
#     #       @  #  # #
#######          #  # #
#     #          #  # #
#                #  # #
#                #  ###
#                #
#     #          #
##################