#######################
#     #               #
#                #### #
#                #  # #
#                #  # #
#     #       @  #  # #
#######          #  # #
#     #          #  # #
# B              #  # #
#          H     #  ###
#           H    #
#     #      H   #
########### ######