#######################
#     #               #
#  E       E     #### #
#                #  # #
#                #  # #
#     #       @  #  # #
#######          #  # #
#     #          #  # #
# B              #  # #
#          H     #  ###
# P         H    #
#   A #      H   #
########### ######