#######################
#     #               #
#                #### #
#                #  # #
#                #  # #
#     #       @  #  # #
#######          #  # #
#     #          #  # #
# B           E  #  # #
#     E    E     #  ###
# P         E    #
#   A #      E   #
########### ######