#################
#      @       E#
#               #
#     E         #
#               #
#               #
#    E E E      #
#               #
#    P P P      #
#               #
#    A A A      #
#               #
#    B B B      #
#               #
#            E  #
#   E           #
######     ######